7,-1,-1,0,0,0,0,1
0,1, 0,2,  5,4,-1,0
0,-1,-1,0,-1,0,-1,0
-1,-1,0,0,-1,0,-1,3
0,2,-1,1,2,5,-1,7
4,0,5,-1,-1,0,0,0